00000000
00000000
00000000
00000000
00000000
00000000
00001111
00001111
00001111
00001111
00010000
00010000
00010000
00010000
00010000
00010000
00100000
00100000
00100000
00100000
00100000
00100000
00110001
00110001
00110001
00110001
00110001
00110001
00110001
00110001
00110001
00110001
00110001
00110001
00110001
00110001
00111011
00111011
00111011
00111011
00111011
00111011
00111011
00111011
00111011
00111011
00010000
00010000
00010000
00010000
00010000
00010000
00010000
00010000
00010000
00010000
00000000
00000000
00000000
00000000
00000000
00000000
00000000
00000000
00000000
00000000
11110000
11110000
11110000
11110000
11110000
11110000
11110000
11110000
11110000
11110000
00101000
00101000
00101000
00101000
00101000
00101000
00101000
00101000
00101000
00101000
00000000
00000000
00000000
00000000
00000000
00000000
00000000
00000000
00000000
00000000
00111110
00111110
00111110
00111110
00111110
00111110
00111110
00111110
00111110
00111110
00000000
00000000
00000000
00000000
00000000
00000000
01111110
01111110
01111110
01111110
01111110
01111110
11111000
11111000
11111000
11111000
11111000
11111000
00010100
00010100
